1111111111111111111111111
1P0000000000000C0000000C1
1011111011111110111111101
1000000100C00000000000001
1011101110111011111010101
1C000C000C000000000C00001
1011101011101011101011101
1000000000000000000C00001
1011111010111110111110001
111000C0000000000C0000001
10101110111C1110111010101
10000000C1111100000000C01
1011111010111110011111101
1C00000000000C00000000E01
1111111111111111111111111