1111111111111111111111111111111111
10000000001100000000000000000000E1
1000000000110000000000000000000001
1000000000110000000000000000000001
100000000C100000000000000000000001
100000110011C0000000000C0000000001
100P000000110000000000000000000001
1000000000010000000000000000000001
1000000000110000000000C00000000001
1000000000110000000000000000000001
1000000000110000000000000000000001
1000000000110000000000000000000001
1111111111111111111111111111111111