1111111111111111111111111111111111
1E0010100000000C00000C000000000001
101010P000100000101001000000010101
1100011000101010001001000000010101
100000000C00C0000000000000000000C1
1111111111111111111111011111111111