1111111111111111111111
1010001111101110101111
1010111111111111111011
1000010P00001000001111
1011111011111010111011
1111111011101010001011
1000111011111010111011
1010101000111110101011
1110111110001010111011
1000C00C101000000000E1
1111111111111111111111